R 1920 1080   

NO ./textures/matrix.png
SO ./textures/matrix.png
WE ./textures/matrix.png
EA ./textures/matrix.png
S ./textures/neo.png

F  186,252,195    
C  0,0,0


        1111111111111111111111111 
        1000000000110000000000001
        1011000001110020002000001
        1001000000000000000000001
111111111011000001110000000000001
100000000011000001110111110111111
11110111111111011100000010001
11110111111111011101010010201
11000000110101011100000010001    
10002000000000001100000010001
10000000000000001101010010001
11000001110101011111011110N0111
111101111 110101 101111010001
111111111 111111 111111111111